############
#..I.......#
#..........#
#..........#
#..........#
#....P.....#
#I..#.#....#
############